########S#######
#..........#...#
#.######.###.#.#
#.##...#..##.#.#
#....#..##.....#
##.#.########.##
##.#...........I
################