################
#..............I
#.######.###.#.#
#.##...#..##.#.#
#....#..##.....#
##.#.########.##
##.#...........#
##S#############